WTTTTTTTFT
TTTTHSSTTT
FTTTTS1TTT
TTFTZSSTTT
TTTTTTHTTF
